DDDDDDDDDDDDDD
DDDDDDDDDDDDDD
DDDDDDDDDDDDDD
DDDDDDDDDDDDDD
DDDDDDDDDDDDDD
DDDDDDDDDDDDDD
DDDDDDDDDDDDDD
DDDDDDDDDSSDDD
DDDDDSUDUSDUDD
3DUS1DSSDSSSDD
DSSUDDDSDDSDUD
DDUUSSSSAHSSDD
DUSUDDDSDDSDSD
4DUS2DUSDSSUDD
DDDDDSSDSUDSDD
DDDDDDDDDSUDDD
DDDDDDDDDDDDDD
DDDDDDDDDDDDDD
DDDDDDDDDDDDDD
DDDDDDDDDDDDDD
DDDDDDDDDDDDDD
DDDDDDDDDDDDDD
DDDDDDDDDDDDDD