DDUUUUUSUUUUDD
DUDSDDDDD4SUDD
DUDUUUUUUUUDUD
UDUDDDSDDDDUDD
UDUDUUUUUUDUDD
1UDUDDDDDUUDDD
DSDUDUUUUSUDUD
DUUDSDSDUDUSUD
DUUDUDUUDUDUDU
UDUUDUDUDUDDDU
UDSUDUDDSSUDUS
UDSDUADHUDUSUD
UUDUSUDDSDUDDS
USDUDUDUDUSUDU
DUSDSDUUSUDUDS
2UUDUDDDUDUDDU
USUUDUUUUDUDDS
UDUUSDDDDUDDUU
UUDUUUUUUUDDUU
UUDDDDDDSDUUDU
UDUUDDDSDUUUDU
SUUUDDSUDD3DUD
DDUUUUUUUUUUUD