DDDDDDDDDDDDDD
DDDDDDDDDDDDDD
DDDDDDDDDDDDDD
DDDDDDDDDDDDDD
DDDDDDDDDDDDDD
DDDDDDDDDDDDDD
DDDDDDUUDDDDDD
DDDDDU1USDDDDD
DDDDDDUUDUDDDD
DDDDDDSDDUDDDD
DDDD3USUUDSDDD
DDDDUAUHUSDDDD
DDDD4USUUDSDDD
DDDDDDSDDUDDDD
DDDDDDUUDUDDDD
DDDDDU2USDDDDD
DDDDDDUUDDDDDD
DDDDDDDDDDDDDD
DDDDDDDDDDDDDD
DDDDDDDDDDDDDD
DDDDDDDDDDDDDD
DDDDDDDDDDDDDD
DDDDDDDDDDDDDD